[console_scripts]
add-git-credentials = utils.scripts:add_git_credentials
build-static-docs = utils.scripts:build_static_docs
build-versioned-docs = utils.scripts:build_versioned_docs
bump-version = utils.bump_version:main
check = utils.scripts:check
check-black = utils.scripts:check_black
check-blacken_docs = utils.scripts:check_blacken_docs
check-build = utils.scripts:check_build
check-codespell = utils.scripts:check_codespell
check-docstrings = utils.scripts:check_docstrings_cli
check-isort = utils.scripts:check_isort
check-mkdocs = utils.scripts:check_mkdocs
check-mypy = utils.scripts:check_mypy
check-pycln = utils.scripts:check_pycln
check-pylint = utils.scripts:check_pylint
check-pytest = utils.scripts:check_pytest
docs-build-static = utils.scripts:docs_build_static
docs-build-versioned = utils.scripts:docs_build_versioned
docs-check-versions = utils.scripts:docs_check_versions
docs-delete-version = utils.scripts:docs_delete_version
docs-serve-static = utils.scripts:docs_serve_static
docs-serve-versioned = utils.scripts:docs_serve_versioned
docs-set-default = utils.scripts:docs_set_default
git-add-coverage-report = utils.scripts:git_add_coverage_report
git-fix-tag-reference = utils.scripts:git_fix_tag_reference
git-refresh-current-branch = utils.scripts:git_refresh_current_branch
git-switch-to-docs-branch = utils.scripts:git_switch_to_docs_branch
git-switch-to-main-branch = utils.scripts:git_switch_to_main_branch
git-update-version = utils.scripts:git_update_version
lint = utils.scripts:lint
lint-check = utils.scripts:lint_check
run-black = utils.scripts:run_black
run-blacken_docs = utils.scripts:run_blacken_docs
run-isort = utils.scripts:run_isort
run-pycln = utils.scripts:run_pycln
run-pyupgrade = utils.scripts:run_pyupgrade
sync = utils.scripts:uv_sync
update-git-docs = utils.scripts:update_git_docs

